111111111111111111111111111111111111111111111111111111
1C0000C1000000000000010000000C000000C000000000000C0001
1C0000C100001CCCC0000000000000000000000000000000000001
1C0000C1000000000000C0000000000000000C0000000000C00001
1E0P00CCC0000000000000000000C0C00000000000000000000001
111111111111111111111111111111111111111111111111111111