111111111111111111111111111111
1C0000C100000000000000000C0001
1C0000C100001CC000000000000001
1C0000C1000000000000000C000001
1E0P00CCC000000000000000000001
111111111111111111111111111111
