1111111111111111111
1C0000C100C10000001
1C0000C1000100E0001
1C0000C100P10000001
100P00CCC0010E00001
1111111111111111111
