1111111111111111111
1C0000C100C00000001
1C0000C100000000001
1C0000C100000000001
1E0P00CCC0000000001
1111111111111111111
