11111111
1C0W00C1
1C00W0C1
1C0000C1
1E0P0011
11111111
