111111
1C0EC1
100P11
111111
