1111111111111111111
1C0000C100C10000001
1C0000C100010000001
1C0000C10E010000001
100P00CCC0000CC0001
1111111111111111111
